Mystery game
An Interactive Fiction by Mateja Zunec
Release 1 / Serial number 240117 / Inform 7 v10.1.2 / D

Hallway
You entered the house. The hallway runs from south to north. In the north wall is the closet.  In west wall is a Old wooden door. A long hallway painted with gray walls. There are pictures on the walls.

You can see an Old wooden door and Red locker (closed) here.

>go north
You can't go that way.

>go south
That's where the ghost is.

* * *

Mystery game
An Interactive Fiction by Mateja Zunec
Release 1 / Serial number 240117 / Inform 7 v10.1.2 / D

Hallway
You entered the house. The hallway runs from south to north. In the north wall is the closet.  In west wall is a Old wooden door. A long hallway painted with gray walls. There are pictures on the walls.

You can see an Old wooden door and Red locker (closed) here.

>open door
(first unlocking the Old wooden door with the old key, then opening the door)

Courage is profitable, 5 points for you.

Kitchen
It's so quiet here, like there's no one, but there's someone. There was big brown table in the middle. The man is standing near table. There is a vase with flowers on the table.

You can see an Old wooden door, a Black door, a brown table (on which is a plate) and Jimmy here.

[Your score has just gone up by five points.]

>ask Jimmy
(for the old key)
(Jimmy first taking the old key)
Jimmy has better things to do.

* * *

Mystery game
An Interactive Fiction by Mateja Zunec
Release 1 / Serial number 240117 / Inform 7 v10.1.2 / D

Hallway
You entered the house. The hallway runs from south to north. In the north wall is the closet.  In west wall is a Old wooden door. A long hallway painted with gray walls. There are pictures on the walls.

You can see an Old wooden door and Red locker (closed) here.

>enter Black door
(first opening the Black door)
It seems to be locked.

    *** Game over! ***

In that game you scored 0 out of a possible 0, in 1 turn.

Would you like to RESTART, RESTORE a saved game, QUIT or UNDO the last command?

* * *

Mystery game
An Interactive Fiction by Mateja Zunec
Release 1 / Serial number 240117 / Inform 7 v10.1.2 / D

Hallway
You entered the house. The hallway runs from south to north. In the north wall is the closet.  In west wall is a Old wooden door. A long hallway painted with gray walls. There are pictures on the walls.

You can see an Old wooden door and Red locker (closed) here.

>enter Old wooden door
(first unlocking the Old wooden door with the old key, then opening the door)

Courage is profitable, 5 points for you.

Kitchen
There was big brown table in the middle. There is a vase with flowers on the table.

You can see an Old wooden door and Jimmy here.

[Your score has just gone up by five points.]

>enter Old wooden door
Courage is profitable, 5 points for you.

Kitchen
There was big brown table in the middle. There is a vase with flowers on the table.

You can see an Old wooden door and Jimmy here.

[Your score has just gone up by five points.]

* * *

>open door
(first unlocking the Old wooden door with the old key, then opening the door)

Courage is profitable, 5 points for you.

Kitchen
There was big brown table in the middle. There is a vase with flowers on the table.

You can see an Old wooden door, a Black door and Jimmy here.

[Your score has just gone up by five points.]

>open Black door
You open the Black door.

>go through black door
Living room
The living room is dark. You can see a bookshelf and an old armchair.

You can see a Black door and Zara here.

* * *

>who is Jimmy?
That's not a verb I recognise.

* * *

Mystery game
An Interactive Fiction by Mateja Zunec
Release 1 / Serial number 240117 / Inform 7 v10.1.2 / D

Hallway
You entered the house. The hallway runs from south to north. In the north wall is the closet.  In west wall is a Old wooden door. A long hallway painted with gray walls. There are pictures on the walls.

You can see an Old wooden door and Red locker (closed) here.

>go south
You can't go that way.

>go north
You can't go that way.

>go to kitchen
You can't see any such thing.

* * *

Mystery game
An Interactive Fiction by Mateja Zunec
Release 1 / Serial number 240117 / Inform 7 v10.1.2 / D

Hallway
You entered the house. The hallway runs from south to north. In the north wall is the closet.  In west wall is a Old wooden door. A long hallway painted with gray walls. There are pictures on the walls.

You can see an Old wooden door and Red locker (closed) here.

>go throght door
You can't see any such thing.

>go through door
Courage is profitable, 5 points for you.

Kitchen
There was big brown table in the middle. There is a vase with flowers on the table.

You can see an Old wooden door and Jimmy here.

[Your score has just gone up by five points.]

* * *

>open door
(first unlocking the Old wooden door with the old key, then opening the door)

Courage is profitable, 5 points for you.

Kitchen
It's so quiet here, like there's no one, but there's someone. There was big brown table in the middle. The man is standing near table. There is a vase with flowers on the table.

You can see an Old wooden door, a Black door, a brown table (on which is a plate) and Jimmy here.

[Your score has just gone up by five points.]

>Ask Jimmy for help
You can't see any such thing.

>talko to Jimmy
That's not a verb I recognise.

>talk to Jimmy
"My name is Lucy. How do I get out of the house? I'm scared" .

Hi Lucy, my name is Jimmy. You must find third key. The golden one. That's all I can tell you. - he replies seriously and left the room.
There is something on the table. Check it!

* * *

Mystery game
An Interactive Fiction by Mateja Zunec
Release 1 / Serial number 240117 / Inform 7 v10.1.2 / D

Hallway
You entered the house. The hallway runs from south to north. In the north wall is the closet.  In west wall is a Old wooden door. A long hallway painted with gray walls. There are pictures on the walls.

You can see an Old wooden door and Red locker (closed) here.

>go through door
(first opening the Old wooden door)
(first unlocking the Old wooden door with the old key, then opening the door)

Courage is profitable, 5 points for you.

Kitchen
There was big brown table in the middle. There is a vase with flowers on the table.

You can see an Old wooden door and Jimmy here.

Kitchen
There was big brown table in the middle. There is a vase with flowers on the table.

You can see an Old wooden door and Jimmy here.

[Your score has just gone up by five points.]

* * *

Mystery game
An Interactive Fiction by Mateja Zunec
Release 1 / Serial number 240117 / Inform 7 v10.1.2 / D

Hallway
You entered the house. The hallway runs from south to north. In the north wall is the closet.  In west wall is a Old wooden door. A long hallway painted with gray walls. There are pictures on the walls.

You can see an Old wooden door and Red locker (closed) here.

>go throught door
You can't see any such thing.

>open door
(first unlocking the Old wooden door with the old key, then opening the door)

Courage is profitable, 5 points for you.

Kitchen
There was big brown table in the middle. There is a vase with flowers on the table.

You can see an Old wooden door and Jimmy here.

[Your score has just gone up by five points.]

>open old wooden door
Courage is profitable, 5 points for you.

Kitchen
There was big brown table in the middle. There is a vase with flowers on the table.

You can see an Old wooden door and Jimmy here.

[Your score has just gone up by five points.]

* * *

Mystery game
An Interactive Fiction by Mateja Zunec
Release 1 / Serial number 240117 / Inform 7 v10.1.2 / D

Hallway
You entered the house. The hallway runs from south to north. In the north wall is the closet.  In west wall is a Old wooden door. A long hallway painted with gray walls. There are pictures on the walls.

You can see an Old wooden door and Red locker (closed) here.

>go to Red locker
You can't see any such thing.

>open Red locker
You open Red locker.

* * *

Mystery game
An Interactive Fiction by Mateja Zunec
Release 1 / Serial number 240117 / Inform 7 v10.1.2 / D

Hallway
You entered the house. The hallway runs from south to north. In the north wall is the closet.  In west wall is a Old wooden door. A long hallway painted with gray walls. There are pictures on the walls.

You can see an Old wooden door and Red locker (closed) here.

>open Old wooden door
(first unlocking the Old wooden door with the old key, then opening the door)

Courage is profitable, 5 points for you.

Kitchen
It's so quiet here, like there's no one, but there's someone. There was big brown table in the middle. The man is standing near table. The smell of chocolate cake is in the air.

You can see an Old wooden door, a Black door, a brown table (on which is a plate (on which are a cake and eight pieces of cake)) and Jimmy here.

[Your score has just gone up by five points.]

>ask Jimmy for help
You can't see any such thing.

* * *

>open Old wooden door
(first unlocking the Old wooden door with the old key, then opening the door)

Courage is profitable, 5 points for you.

Kitchen
It's so quiet here, like there's no one, but there's someone. There was big brown table in the middle. The man is standing near table. The smell of chocolate cake is in the air.

You can see an Old wooden door, a Black door, a brown table (on which is a plate (on which are a cake and eight pieces of cake)) and Jimmy here.

[Your score has just gone up by five points.]

>eat cake
Which do you mean, the cake or a piece of cake?

>eat piece of cake
(first taking the piece of cake)
Delicious chocolate cake, but you still don't have the third key!

>open Black door
That's already open.

>go throught door
You can't see any such thing.

>go through door
Which do you mean, the Old wooden door or the Black door?

>go through door Black door
Living room
The living room is dark and feels cold. A woman stands in the middle of the room and looks through you. It seems she didn't even notice you coming into the room.

You can see a Black door, Zara and a bookshell (empty) here.

>talk to Zara
"Can you hear me? Where is third key?"- Lucy asks.

 "If you want third key, you must gave me the other key." - she replies and standing motionless. 

 "But I have to have all the keys for her to leave the house." -Lucy replies. 

 "That is not true. If you give me the old key, I will give you the answers." - said Zara."

>give old key to Zara
It is a trap! Zara won't help you.

[Your score has just gone down by five points.]

>key
That's not a verb I recognise.

>talk to Zara
"Can you hear me? Where is third key?"- Lucy asks.

 "If you want third key, you must gave me the other key." - she replies and standing motionless. 

 "But I have to have all the keys for her to leave the house." -Lucy replies. 

 "That is not true. If you give me the old key, I will give you the answers." - said Zara."

>give old key to Zara
(first taking the old key)
That seems to belong to Zara.

>talk to Zara
"Can you hear me? Where is third key?"- Lucy asks.

 "If you want third key, you must gave me the other key." - she replies and standing motionless. 

 "But I have to have all the keys for her to leave the house." -Lucy replies. 

 "That is not true. If you give me the old key, I will give you the answers." - said Zara."

* * *

>give old key to Zara
(first taking the old key)
That seems to belong to Zara.

>what i can see in Living room
That's not a verb I recognise.

* * *

Mystery game
An Interactive Fiction by Mateja Zunec
Release 1 / Serial number 240117 / Inform 7 v10.1.2 / D

Hallway
You entered the house. The hallway runs from south to north. In the north wall is the closet.  In west wall is a Old wooden door. A long hallway painted with gray walls. There are pictures on the walls.

You can see an Old wooden door and Red locker (closed) here.

>open Red locker
You found rusty key!

[Your score has just gone up by five points.]

>go through Old wooden door
(first unlocking the Old wooden door with the old key, then opening the door)

Courage is profitable, 5 points for you.

Kitchen
There was big brown table in the middle. There is a vase with flowers on the table.

You can see an Old wooden door and Jimmy here.

[Your score has just gone up by five points.]

>go throught Old wooden door
You can't see any such thing.

>go through Old wooden door
Courage is profitable, 5 points for you.

Kitchen
There was big brown table in the middle. There is a vase with flowers on the table.

You can see an Old wooden door and Jimmy here.

[Your score has just gone up by five points.]

* * *

>open Old wooden door
(first unlocking the Old wooden door with the old key, then opening the door)

Courage is profitable, 5 points for you.

Kitchen
It's so quiet here, like there's no one, but there's someone. There was big brown table in the middle. The man is standing near table. The smell of chocolate cake is in the air.

You can see an Old wooden door, a Black door, a brown table (on which is a plate (on which are five pieces of cake)) and Jimmy here.

[Your score has just gone up by five points.]

>talk to Jimmy
"My name is Lucy. How do I get out of the house? I am scared" .

Hi Lucy, my name is Jimmy. You must find third key. The golden one. That's all I can tell you. - he replies seriously and left the room.
There is something on the table. Check it!

>eat cake
(first taking the piece of cake)
Delicious chocolate cake, but you still don't have the third key!

>go through Black door
Living room
The living room is dark and feels cold. A woman stands in the middle of the room and looks through you. It seems she didn't even notice you coming into the room.

You can see a Black door, a Green door, Zara and a bookshell (in which is a book (closed)) here.

>talk to Zara
"Can you hear me? Where is third key?"- Lucy asks.

 "If you want third key, you must gave me the other key." - she replies and standing motionless. 

 "But I have to have all the keys for her to leave the house." -Lucy replies. 

 "That is not true. If you give me the old key, I will give you the answers." - said Zara."

* * *

>give old key to Zara
It is a trap! Zara won't help you.

[Your score has just gone down by five points.]

>open bookshell
That's already open.

>open book
The book hides a secret message: "Dreams are sweet, but reality is bitter. Finding the key is a real pain. Find the chest first!"

[Your score has just gone up by ten points.]

>open Green door
Work room
You enter the room. It is painted green and unlike the previous room, it is somehow calm.

You can see a Green door, a Light door, a desk, a showcase (closed) and an armchair here.

>open showcase
You open the showcase, revealing a chest.

>take a chest
Taken.

>open a chect
You can't see any such thing.

>open a chest
It's locked.The third key unlocks, but you can take it with you.

>unlock a chest
What do you want to unlock the chest with?

>unlock a chest with old key
You can't see any such thing.

>open a chest
It's locked.The third key unlocks, but you can take it with you.

>take a cest
You can't see any such thing.

>take a chest
You already have that.

>open Light door
Darkness
It is too dark, and you can't see a thing.

>turn on lights
You turn on the lights.

Bedroom
A dark bedroom. Moonlight comes through the window, but it's too dark to see anything. 

You can see a Light door, a bed and Wall lamp (providing light) here.

>switch on
What do you want to switch on?

>switch on light
(the Light door)
It isn't something you can switch.

>turn on lights
You turn on the lights.

>switch on lights
You turn on the lights.

>switch on lamp
It isn't something you can switch.

>turn on lights
You turn on the lights.

>turn on light
(the Light door)
It isn't something you can switch.

>swich light
That's not a verb I recognise.

>lit lamp
That's not a verb I recognise.

>switch on light
(the Light door)
It isn't something you can switch.

>switch
What do you want to switch?

>switch on
What do you want to switch on?

>switch on the light-switch
You turn on the lights.

>switch off the light-switch
You turn off the lights.

Turn on lights.

>switch on the light-switch
You turn on the lights.

Bedroom
A dark bedroom. Moonlight comes through the window, but it's too dark to see anything. 

You can see a Light door, a bed and Wall lamp (providing light) here.

>turn on lights
You turn on the lights.

>turn off
You must supply a noun.

>turn off lights
You turn off the lights.

Turn on lights.

>turn on lights
You turn on the lights.

Bedroom
A dark bedroom. Moonlight comes through the window, but it's too dark to see anything. 

You can see a Light door, a bed and Wall lamp (providing light) here.

>look under the bed
Something glow... Oh, it is golden key!

>take key
Which do you mean, the golden key or the rusty key?

>take golden key
You already have that.

>look under the bed
There is nothing under there, just a lot of dust.

>open chest
It's locked.The third key unlocks, but you can take it with you.

>unlock the chest
What do you want to unlock the chest with?

>unock the chest with golden key
You can't see any such thing.

>open the chest
It's locked.The third key unlocks, but you can take it with you.

>open the chest
It's locked.The third key unlocks, but you can take it with you.

>open chest
It's locked.The third key unlocks, but you can take it with you.

>unlock chest
What do you want to unlock the chest with?

>unlock chest with golden key
Unlocking!

>unlock chest with the golden key
You need golden key!

>unlock chest with the golden key
You need golden key!

>look under the bed
There is nothing under there, just a lot of dust.

>take key
Which do you mean, the golden key or the rusty key?

>take the golden key
You already have that.

>open the chest
It's locked.The third key unlocks, but you can take it with you.

>unlock the chest with golden key
You need golden key!

>unlock the chest with golden key
You need golden key!

* * *

>open Red locker
You found rusty key!

[Your score has just gone up by five points.]

>take rusy key
You can't see any such thing.

* * *

Mystery game
An Interactive Fiction by Mateja Zunec
Release 1 / Serial number 240117 / Inform 7 v10.1.2 / D

Hallway
You entered the house. The hallway runs from south to north. In the north wall is the closet.  In west wall is a Old wooden door. A long hallway painted with gray walls. There are pictures on the walls.

You can see an Old wooden door and Red locker (closed) here.

>open door
(first unlocking the Old wooden door with the old key, then opening the door)

Courage is profitable, 5 points for you.

Kitchen
It's so quiet here, like there's no one, but there's someone. There was big brown table in the middle. The man is standing near table. The smell of chocolate cake is in the air.

You can see an Old wooden door, a Black door, a brown table (on which is a plate (on which are five pieces of cake)) and Jimmy here.

[Your score has just gone up by five points.]

>ask Jimmy
(for the old key)
(Jimmy first taking the old key)
Jimmy has better things to do.

>ask Jimmy for the old key
(Jimmy first taking the old key)
Jimmy has better things to do.

* * *

>open door
(first unlocking the Old wooden door with the old key, then opening the door)

Courage is profitable, 5 points for you.

Kitchen
It's so quiet here, like there's no one, but there's someone. There was big brown table in the middle. The man is standing near table. The smell of chocolate cake is in the air.

You can see an Old wooden door, a Black door, a brown table (on which is a plate (on which are five pieces of cake)) and Jimmy here.

[Your score has just gone up by five points.]

>eat cake
(first taking the piece of cake)
Delicious chocolate cake, but you still don't have the third key!

>eat the cake
(first taking the piece of cake)
Delicious chocolate cake, but you still don't have the third key!

>eat a piece of cake
(first taking the piece of cake)
Delicious chocolate cake, but poisoned!

[Your score has just gone down by five points.]

>eat a piece of cake
(first taking the piece of cake)
Delicious chocolate cake, but you still don't have the third key!

>eat a piece of cake
(first taking the piece of cake)
Delicious chocolate cake, but you still don't have the third key!

>eat a piece of cake
You can't see any such thing.

* * *

>open door
(first unlocking the Old wooden door with the old key, then opening the door)

Courage is profitable, 5 points for you.

Kitchen
It's so quiet here, like there's no one, but there's someone. There was big brown table in the middle. The man is standing near table. The smell of chocolate cake is in the air.

You can see an Old wooden door, a Black door, a brown table (on which is a plate (on which are five pieces of cake)) and Jimmy here.

[Your score has just gone up by five points.]

>eat piece of cake
(first taking the piece of cake)
Delicious chocolate cake, but poisoned!

[Your score has just gone down by five points.]

>eat piece of cake
(first taking the piece of cake)
Delicious chocolate cake, but you still don't have the third key!

>eat piece of cake
(first taking the piece of cake)
Delicious chocolate cake, but you still don't have the third key!

>eat cake
(first taking the piece of cake)
Delicious chocolate cake, but you still don't have the third key!

>open black door
That's already open.

>go through door
Which do you mean, the Old wooden door or the Black door?

>go through black door
Living room
The living room is dark and feels cold. A woman stands in the middle of the room and looks through you. It seems she didn't even notice you coming into the room.

You can see a Black door, a Green door, Zara and a bookshell (in which is a book (closed)) here.

>talk to Zara
"Can you hear me? Where is third key?"- Lucy asks.

 "If you want third key, you must gave me the other key." - she replies and standing motionless. 

 "But I have to have all the keys for her to leave the house." -Lucy replies. 

 "That is not true. If you give me the old key, I will give you the answers." - said Zara."

* * *

>give old key to Zara
It is a trap! Zara won't help you.

[Your score has just gone down by five points.]

>talk to Zara
"Can you hear me? Where is third key?"- Lucy asks.

 "If you want third key, you must gave me the other key." - she replies and standing motionless. 

 "But I have to have all the keys for her to leave the house." -Lucy replies. 

 "That is not true. If you give me the old key, I will give you the answers." - said Zara."

>open bookshell
That's already open.

>open book
The book hides a secret message: "Dreams are sweet, but reality is bitter. Finding the key is a real pain."

[Your score has just gone up by ten points.]

>open Green door
Work room
You enter the room. It is painted green and unlike the previous room, it is somehow calm.

You can see a Green door and a desk here.

* * *

>go through door
(first opening the Old wooden door)

>opening the Old wooden door
That's not a verb I recognise.

* * *

>go throught door
You can't see any such thing.

>enter door
There is no return anymore! Ask Jimmy for the help
Kitchen
There was big brown table in the middle. There is a vase with flowers on the table.

You can see an Old wooden door and Jimmy here.

* * *

>open
(the old key)
It isn't something you can open.

* * *

>open door
Courage is profitable, 5 points for you.

Kitchen
There was big brown table in the middle. There is a vase with flowers on the table.

You can see an Old wooden door and Jimmy here.

[Your score has just gone up by five points.]

* * *

>open door
(first unlocking the Old wooden door with the old key, then opening the door)

Courage is profitable, 5 points for you.

Kitchen
It's so quiet here, like there's no one, but there's someone. There was big brown table in the middle. The man is standing near table. The smell of chocolate cake is in the air.

You can see an Old wooden door, a Black door, a brown table (on which is a plate (on which are five pieces of cake)) and Jimmy here.

[Your score has just gone up by five points.]

>open dor
You can't see any such thing.

* * *

>enter door
There is no return anymore! Ask Jimmy for the help
Kitchen
There was big brown table in the middle. There is a vase with flowers on the table.

You can see an Old wooden door and Jimmy here.

* * *

>open door
(first unlocking the Old wooden door with the old key, then opening the door)

Courage is profitable, 5 points for you.

Kitchen
It's so quiet here, like there's no one, but there's someone. There was big brown table in the middle. The man is standing near table. The smell of chocolate cake is in the air.

You can see an Old wooden door, a Black door, a brown table (on which is a plate (on which are five pieces of cake)) and Jimmy here.

[Your score has just gone up by five points.]

>read message
No entry!

* * *

>open door
(first unlocking the Old wooden door with the old key, then opening the door)

Courage is profitable, 5 points for you.

Kitchen
It's so quiet here, like there's no one, but there's someone. There was big brown table in the middle. The man is standing near table. The smell of chocolate cake is in the air.

You can see an Old wooden door, a Black door, a brown table (on which is a plate (on which are five pieces of cake)) and Jimmy here.

[Your score has just gone up by five points.]

>tak to Jimmy
That's not a verb I recognise.

>talk to JImmy
"My name is Lucy. How do I get out of the house? I'm scared" .

Hi Lucy, my name is Jimmy. You must find third key. The golden one. That's all I can tell you. -he replies seriously and left the room.

>talko to JImmy
That's not a verb I recognise.

>talk to Jimmy
"My name is Lucy. How do I get out of the house? I'm scared" .

Hi Lucy, my name is Jimmy. You must find third key. The golden one. That's all I can tell you. -he replies seriously and left the room.

* * *

>open door
(first unlocking the Old wooden door with the old key, then opening the door)

Courage is profitable, 5 points for you.

Kitchen
It's so quiet here, like there's no one, but there's someone. There was big brown table in the middle. The man is standing near table. The smell of chocolate cake is in the air.

You can see an Old wooden door, a Black door, a brown table (on which is a plate (on which are five pieces of cake)) and Jimmy here.

[Your score has just gone up by five points.]

>unlock door
(with the old key)
You unlock the Old wooden door.

>go through door
Courage is profitable, 5 points for you.

Kitchen
There was big brown table in the middle. There is a vase with flowers on the table.

You can see an Old wooden door and Jimmy here.

[Your score has just gone up by five points.]

* * *

>unlock door
(with the old key)
You unlock the Old wooden door.

>open door
You open the Old wooden door.

>go through door
Courage is profitable, 5 points for you.

Kitchen
There was big brown table in the middle. There is a vase with flowers on the table.

You can see an Old wooden door and Jimmy here.

[Your score has just gone up by five points.]

>open door
That's already open.

* * *

Mystery game
An Interactive Fiction by Mateja Zunec
Release 1 / Serial number 240117 / Inform 7 v10.1.2 / D

Hallway
You entered the house. The hallway runs from south to north. In the north wall is the closet.  In west wall is a Old wooden door. A long hallway painted with gray walls. There are pictures on the walls.

You can see an Old wooden door and Red locker (closed) here.

>open locker
You found rusty key!

[Your score has just gone up by five points.]

>tak key
That's not a verb I recognise.

>take key
Which do you mean, the rusty key or the old key?

>rusty
You already have that.

>take old key
You already have that.

>open door
(first unlocking the Old wooden door with the old key, then opening the door)

Courage is profitable, 5 points for you.

Kitchen
There was big brown table in the middle. There is a vase with flowers on the table.

You can see an Old wooden door and Jimmy here.

[Your score has just gone up by five points.]

* * *

>open locker
You found rusty key!

[Your score has just gone up by five points.]

>take key
Which do you mean, the rusty key or the old key?

>open Old wooden door
It seems to be locked.

>unlocked door
That's not a verb I recognise.

>unlocked Old wooden door
That's not a verb I recognise.

>go through Old wooden door
Courage is profitable, 5 points for you.

Kitchen
There was big brown table in the middle. There is a vase with flowers on the table.

You can see an Old wooden door and Jimmy here.

[Your score has just gone up by five points.]

* * *

>take key
Which do you mean, the rusty key or the old key?

>take rusty key
You already have that.

>open door
(first unlocking the Old wooden door with the old key, then opening the door)

Courage is profitable, 5 points for you.

Kitchen
It's so quiet here, like there's no one, but there's someone. There was big brown table in the middle. The man is standing near table. The smell of chocolate cake is in the air.

You can see an Old wooden door, a Black door, a brown table (on which is a plate (on which are a cake and eight pieces of cake)) and Jimmy here.

[Your score has just gone up by five points.]

>talk to Jimmy
"My name is Lucy. How do I get out of the house? I am scared" .

Hi Lucy, my name is Jimmy. You must find third key. The golden one. That's all I can tell you. - he replies seriously and left the room.
There is something on the table. Check it!

>eat piece of cake
(first taking the piece of cake)
Delicious chocolate cake, but you still don't have the third key!

* * *

>open locker
You found rusty key!

[Your score has just gone up by five points.]

>take rusty key
You already have that.

>open Old wooden door
(first unlocking the Old wooden door with the old key, then opening the door)

Courage is profitable, 5 points for you.

Kitchen
It's so quiet here, like there's no one, but there's someone. There was big brown table in the middle. The man is standing near table. The smell of chocolate cake is in the air.

You can see an Old wooden door, a Black door, a brown table (on which is a plate (on which are five pieces of cake)) and Jimmy here.

[Your score has just gone up by five points.]

* * *

Mystery game
An Interactive Fiction by Mateja Zunec
Release 1 / Serial number 240117 / Inform 7 v10.1.2 / D

Hallway
You entered the house. The hallway runs from south to north. In the north wall is the closet.  In west wall is a Old wooden door. A long hallway painted with gray walls. There are pictures on the walls.

You can see an Old wooden door and Red locker (closed) here.

>open red locker
You found rusty key!

[Your score has just gone up by five points.]

>open old wooden door
(first unlocking the Old wooden door with the old key, then opening the door)

Courage is profitable, 5 points for you.

Kitchen
It's so quiet here, like there's no one, but there's someone. There was big brown table in the middle. The man is standing near table. The smell of chocolate cake is in the air.

You can see an Old wooden door, a Black door, a brown table (on which is a plate (on which are five pieces of cake)) and Jimmy here.

[Your score has just gone up by five points.]

>open door
(first unlocking the Old wooden door with the old key, then opening the door)

* * *

>open old wooden door
(first unlocking the Old wooden door with the old key, then opening the door)

Courage is profitable, 5 points for you.

Kitchen
It's so quiet here, like there's no one, but there's someone. There was big brown table in the middle. The man is standing near table. The smell of chocolate cake is in the air.

You can see an Old wooden door, a Black door, a brown table (on which is a plate (on which are five pieces of cake)) and Jimmy here.

[Your score has just gone up by five points.]

>talk to Jimmy
"My name is Lucy. How do I get out of the house? I am scared" .

Hi Lucy, my name is Jimmy. You must find third key. The golden one. That's all I can tell you. - he replies seriously and left the room.
There is something on the table. Check it!

* * *

>go through Black door
Living room
The living room is dark and feels cold. A woman stands in the middle of the room and looks through you. It seems she didn't even notice you coming into the room.

You can see a Black door, a Green door, Zara and a bookshell (in which is a book (closed)) here.

>open book
The book hides a secret message: "Dreams are sweet, but reality is bitter. Finding the key is a real pain. Find the chest first!"

[Your score has just gone up by ten points.]

* * *

>open showcase
You open the showcase, revealing a chest.

>open a chest
It's locked.The third key unlocks, but you can take it with you.

>take the chest
Taken.

>open a Light room
I only understood you as far as wanting to open the Light door.

>open Light door
Darkness
It is too dark, and you can't see a thing.

* * *

>look under the bed
Something glow... Oh, it is golden key!

>take the golden key
You already have that.

>unlock chest with golden key
Unlocking!

>open chest
It's locked.The third key unlocks, but you can take it with you.

>open the chest
It's locked.The third key unlocks, but you can take it with you.

* * *

>open old wooden door
(first unlocking the Old wooden door with the old key, then opening the door)

Courage is profitable, 5 points for you.

Kitchen
It's so quiet here, like there's no one, but there's someone. There was big brown table in the middle. The man is standing near table. The smell of chocolate cake is in the air.

You can see an Old wooden door, a Black door, a brown table (on which is a plate (on which are five pieces of cake)) and Jimmy here.

[Your score has just gone up by five points.]

>use key
That's not a verb I recognise.

>unlock door
What do you want to unlock the Old wooden door with?

>yes
That was a rhetorical question.

* * *

Mystery game
An Interactive Fiction by Mateja Zunec
Release 1 / Serial number 240117 / Inform 7 v10.1.2 / D

Hallway
You entered the house. The hallway runs from south to north. In the north wall is the closet.  In west wall is a Old wooden door. A long hallway painted with gray walls. There are pictures on the walls.

You can see an Old wooden door and Red locker (closed) here.

>read message
No entry!

>enter
You must supply a noun.

>enter door
That's not something you can enter.

>go through door
That's not something you can enter.

* * *

>read message
No entry!

>go south
You can't go that way.

* * *

>go north
You can't go that way.

>open Old wooden door
It isn't something you can open.

* * *

>read message
No entry!

>open Old wooden door
Kitchen
There was big brown table in the middle. There is a vase with flowers on the table.

* * *

Mystery game
An Interactive Fiction by Mateja Zunec
Release 1 / Serial number 240117 / Inform 7 v10.1.2 / D

Hallway
You entered the house. The hallway runs from south to north. In the north wall is the closet.  In west wall is a Old wooden door. A long hallway painted with gray walls. There are pictures on the walls.

You can see an Old wooden door and Red locker (closed) here.

>what message?
That's not a verb I recognise.

>read message
No entry!

>open door
It isn't something you can open.